  # # # # #   # # # # # #           # # #  
#           #             # # # # #       #
#       Z           # #               @   #
#             # # #     # # # #         #
#   Z       #                 #       #
#         #                     # # #
  # # # #                     